1111111
10011P1
1E11111
10PC001
1111111
