11111111111111111
111C000111000C111
1C0000001000000C1
11C00000P00000C11
111C000000000C111
1111C0000000C1111
11111C00000C11111
111111C000C111111
1111111CEC1111111
11111111111111111
