1111111
1000P01
1E00001
1000C1
1111111
